#############################FFFFFFFFFF##
#############################..........##
##.........................##..........##
##.........................##..........##
##.........................##..........##
##............##...........##..........##
##............##...........##..........##
##............##...........##..........##
##............##...........##..........##
##............##...........##..........##
##............##...........##..........##
##............##...........##..........##
##............##...........##..........##
##............##...........##..........##
##............##...........##..........##
##............##...........##..........##
##............##...........##..........##
##............##...........##..........##
##............##...........##..........##
##............##...........##..........##
##............##...........##..........##
##............##...........##..........##
##............##...........##..........##
##............##...........##..........##
##............##...........##..........##
##............##...........##..........##
##............##...........##..........##
##............##...........##..........##
##............##.......................##
##SSSSSSSSSSSS##.......................##
#########################################
#########################################
